10
# # # # # # # # # #
. . # . # # # . . #
# . # . . # # . # #
# . # # . . . . # #
# . # # . # . # . e
# . . # . # . # . #
# # . # . # . # . #
# # . # . # . # . #
# . . . . # . . . #
# # # # # # # # # #
