10
# . # # # # # # # #
# . # . # # # . . #
# . # . . # # . # #
# . # # . . . . # #
# . # # . # . # . e
# . . # . # . # . #
# # . # . # . # . #
# # . # . # . # . #
# . . . . # . . . #
# # # # # # # # # #
